5 5
5 7 7 6 4
3 9 8 2 1
2 3 3 7 2
7 7 8 9 5
9 1 2 9 5
0 0 0
4 4 8