5 5
6 5 4 1 4
2 2 8 2 9
3 3 8 9 3
5 9 7 4 9
4 5 7 6 8
0 0 0
4 4 8