5 5
9 5 6 4 2
1 4 5 2 4
2 7 5 8 6
3 6 6 4 5
2 3 9 4 3
0 0 0
4 4 8