5 5
8 7 5 9 4
6 1 4 1 6
7 5 2 4 6
4 8 7 8 3
5 3 4 9 9
0 0 0
4 4 8