5 5
6 2 5 7 3
8 1 5 9 3
9 2 5 9 4
3 6 3 9 9
1 6 8 1 2
0 0 0
4 4 8