7 7
3 7 3 5 8 4 2
8 9 2 1 9 1 2
4 3 7 8 8 4 7
1 3 7 1 7 5 8
5 7 9 8 3 4 5
4 1 9 1 6 1 1
8 9 9 3 1 9 2
0 0 0
6 6 8