7 7
3 2 2 4 7 2 4
1 2 7 9 6 5 4
6 4 5 7 3 5 8
6 2 1 8 2 2 9
4 9 5 3 6 2 4
6 5 3 8 9 5 9
1 9 5 2 3 5 2
0 0 0
6 6 8