7 7
4 3 3 7 1 3 6
7 4 5 3 2 7 1
8 4 4 8 6 5 4
4 1 4 7 6 5 2
5 6 9 7 9 6 1
2 5 3 5 1 2 7
6 6 7 9 2 7 4
0 0 0
6 6 8