7 7
9 8 2 4 4 2 6
1 9 4 4 1 2 1
4 2 1 6 2 9 4
5 8 4 9 3 8 4
8 7 4 2 2 7 6
7 7 8 1 2 1 7
6 2 4 4 4 9 8
0 0 0
6 6 8