7 7
2 9 3 5 5 4 6
4 5 9 8 5 1 2
7 5 1 1 6 3 5
3 8 9 7 9 1 2
2 3 9 1 6 9 3
7 3 1 5 6 1 6
4 4 2 6 9 7 3
0 0 0
6 6 8