9 9
4 6 5 6 5 5 9 1 9
4 2 4 7 8 9 4 8 8
8 1 2 5 4 7 4 5 6
8 9 9 6 7 9 6 6 8
5 5 5 4 2 4 6 2 9
3 4 4 8 5 9 5 2 4
5 4 6 3 5 1 9 3 5
1 1 9 5 3 8 2 1 5
8 8 8 6 3 1 5 8 2
0 0 0
8 8 8