9 9
2 7 8 2 1 3 3 5 2
4 2 9 7 4 9 7 8 8
5 7 5 1 2 4 4 5 2
3 4 3 9 2 3 1 7 8
8 5 1 4 5 5 8 2 4
5 4 7 2 9 4 3 5 3
2 1 3 5 5 8 2 8 5
7 5 9 9 8 8 2 1 7
6 5 1 2 4 1 5 1 3
0 0 0
8 8 8