9 9
6 8 9 7 9 8 3 8 8
5 4 5 9 8 4 5 8 2
5 4 5 6 6 9 2 3 3
4 7 3 4 2 7 7 6 9
8 7 1 4 7 7 1 7 8
1 6 5 7 7 9 9 4 8
4 5 7 8 1 7 6 7 3
8 3 9 1 7 1 2 7 3
8 3 1 5 7 6 4 8 6
0 0 0
8 8 8