9 9
5 1 7 1 9 9 4 6 7
2 6 6 2 5 9 5 7 6
7 5 9 3 4 7 7 3 5
7 9 1 5 5 4 7 6 8
8 8 4 9 8 3 2 5 9
6 2 4 5 4 4 3 1 1
4 8 2 8 7 4 7 8 7
4 3 1 2 7 4 3 9 8
1 9 4 2 8 3 8 9 9
0 0 0
8 8 8