9 9
6 7 5 7 5 2 8 1 9
1 6 4 2 1 1 4 4 1
3 4 3 8 2 4 8 5 6
3 2 3 5 2 1 5 7 7
4 2 4 2 5 2 1 6 9
7 6 2 9 6 1 7 8 2
7 6 8 3 7 3 9 5 9
8 8 7 5 6 4 2 5 8
4 8 7 6 1 8 6 3 8
0 0 0
8 8 8